Cedric Gervais - Touch The Sky (feat. Digital Farm Animals & Dallas Austin)
TJR - Ode To Oi
Celeste Buckingham - RUN RUN RUN
Vicetone - White Lies (feat. Chloe Angelides)
Robin Schulz - Sugar (feat. Francesco Yates)
Mike Perry - The Ocean (feat. Shy Martin)
DNCE - Cake By The Ocean
deadmau5 & Kaskade - I Remember (Radio Edit)
Galantis - No Money
Clean Bandit - Real Love (feat. Jess Glynne)
Robin Schulz - Shed a Light
Madcon - Don't Worry (with Ray Dalton)
David Guetta - Dangerous (Robin Schulz Remix Radio Edit)
The Chainsmokers feat. Daya - Something Just Like This (Don Diablo Remix)
Calvin Harris & Disciples - How Deep Is Your Love
Adrian Lux - Burning (feat. Dante)
Chris Aoun - Beautiful Insomnia
Starley - Call on Me (Ryan Riback Remix)
MUNA - Winterbreak (Tiksto's Deep House Remix)
Calvin Harris - Outside (feat. Ellie Goulding)
Tommy Trash - Dreamer
Lost Frequencies - Are You With Me (Dash Berlin Remix)
Ed Sheeran - Castle on the Hill (Throttle Remix)
Armin van Buuren - Another You (feat. Mr. Probz)
Tigertown - Warriors
KSHMR - Harder (feat. Talay Riley)
Galantis & Hook N Sling - Love On Me
X Ambassadors - Renegades (Stash Konig Remix)
Sam F - Limitless (feat. Sophie Rose)
Dj Fit & Fresh - FourFiveSeconds
ALMA - Chasing Highs (Felix Cartal Remix)
Kygo - Here for You (feat. Ella Henderson)
Dagny - Backbeat
Coldplay - Hymn For The Weekend (Seeb Remix)
Illenium & Kerli - Sound of Walking Away
Illenium - Fortress (Just A Gent Remix) [feat. Joni Fatora]
Adam Lambert - Ghost Town
Sam Feldt - Show Me Love (EDX Remix) (feat. Kimberly Anne)
TiÃ«sto - Summer Nights (feat. John Legend)
Avicii - Seek Bromance (Avicii Vocal Edit)
Avicii - The Nights
