Razihel Aero Chord - Titans
The Great Escape - I Can't Resist (Nebbra Remix)
Lukas Graham - 7 Years (T-Mass Remix) feat. Toby Romeo
Travis Scott feat Future 2 Chainz - 3500 (Yaldah Remix)
TiÃ«sto KSHMR Feat VASSY - Secrets (Instant Party! Remix)
The Chainsmokers feat Charlee - Inside Out (ARMNHMR Remix)
Marshmello - HoMe
Jetta - I'd Love To Change The World (Matstubs Remix)
Alan Walker - Faded (Sep Remix)
New World Sound Thomas Newson - Flute (Tomsize & Simeon Remix)
Dr Dre - The Next Episode (San Holo Remix)
Drake feat Kanye West Lil Wayne Eminem - Monster
Eva Simons Sidney Samson - Escape From Love (T-Mass Remix)
Silento - Watch Me (Whip Nae Nae) (Sikdope remix )
San Holo - We Rise
Calvin Harris feat Ellie Goulding - Outside (Marshmello Remix)
JDX x Samuel James - Mumbai
Galantis - Runaway (Gioni Remix)
TroyBoi - No Substitute ft. Y.A.S
Tomsize Simeon - Jump
Kevin Gates - 2 Phones (Jayceeoh x Styles&Complete Remix)
Daft Punk - Harder, Better, Faster, Stronger (Dillon Francis Remix)
Major Lazer DJ Snake - Lean On feat. MO (CRNKN Remix)
Dimitri Vangelis Wyman - Payback
Clean Bandit - Rockabye Ft. Sean Paul & Anne-Marie (SHAKED Remix)
DJ Snake Lil Jon - Turn Down For What (Onderkoffer Remix)
The Chainsmokers feat Charlee - Don't Let Me Down (W&W Remix)
Keys N Krates - Treat Me Right
Paris Blohm - Into Dust (feat. Elle Vee)
Marshmello - KeEp IT MeLLo (feat. Omar LinX)
Imagine Dragons - Radioactive (Synchronice Remix)
Oliver Heldens - Melody
G Eazy Bebe Rexha - Me, Myself & I (No Sleep Remix)
LOUDPVCK - More Than I Can Take (feat. Karra & Rickyxsan )
