Higher Self - Ghosts (feat. Lauren Mason)
Jinco - Tokyo
Matthew Koma - One Night (Vicetone Remix)
Maurice West - Blaze (Sweet Lies)
Steve Aoki Deorro - Be Yourself
Rey Rey - BANG (K3L BOOTLEG)
Oliver Heldens Becky Hill - Gecko (Overdrive) [Radio Edit]
Sub Focus - Tidal Wave (feat. Alpines)
TiÃ«sto KSHMR - Secrets (Instant Party! Remix)
R3hab KSHMR - Karate (Original Mix)
Sebastian Ingrosso - Reload (feat. Tommy Trash & John Martin)
3OH 3 - Do Or Die
Borgeous Shaun Frank - This Could Be Love feat. Delaney Jane
Armin van Buuren - Ping Pong [Mix Cut] (Hardwell Remix)
Lil Wayne - Right Above It (feat. Drake)
Colleen D Agostino Feat Deadmau5 - Stay (Will Sparks Edit)
Deorro - Five Hours [LE7ELS]
Alan Walker - Faded (PANI & DALTERO Bootleg)
Hardwell - Eclipse
Krewella - Enjoy the Ride (Vicetone Remix)
KSHMR Dzeko Torres - Imaginate
Martin Garrix - Animals (Oliver Heldens Remix)
Oliver Heldens - Koala
Oliver Heldens - Melody (Original Mix)
Kid Ink Tyga Wale YG Rich Homie Quan - Ride Out
Far East Movement - Like A G6 (feat. The Cataracs & DEV)
Dimitri Vegas Martin Garrix Like Mike - Tremor
Firebeatz DubVision - Invincible (Radio Edit) (feat. Ruby Prophet)
Quintino Yves V ft Gia Koka - Unbroken
Martin Garrix - Forbidden Voices
David Guetta - Dangerous (Steve Aoki Remix)
Headhunterz KSHMR - Dharma
Kanye West - POWER
Hellberg Deutgen vs Splitbreed - Collide
Jay Pryor - All This
Zeds Dead Oliver Heldens - You Know (Original Mix)
Martin Garrix - Virus (How About Now)
KSHMR and BASSJACKERS feat SIRAH - Memories
Blake Selby - Never Let Go ft. Twista & Sam Kay
