Rob Bailey & The Hustle Standard - Never Settle
Katy Perry - E.T. (feat. Kanye West)
Rise Against - The First Drop
DeStorm - King Kong
Rise Against - The Good Left Undone
Wiz Khalifa - We Own It (feat. 2 Chainz)
Army of the Pharaohs - Seven
Lostprophets - Bring 'Em Down
Wild For The Night - A$AP Rocky feat. Skrillex and Birdy Nam Nam
Sum 41 - No Apologies
X Ray Dog - Final Hour
Linkin Park - Faint
Kray Twinz - Round One (feat. D&G)
Jay Z - Run This Town
Papa Roach - To Be Loved
Eminem - Till I Collapse
Lethal Bizzle Rari - WorkOut feat. JME & Tempa T
Nine Lashes - Anthem of the Lonely
Freestylers feat. Belle Humble - Cracks (Flux Pavillion)
Rob Bailey & The Hustle Standard - Hungry
Pain - Shut Your Mouth
Manafest - No Plan B
Jimmy Eat World - Pain
50 Cent - New Day (feat. Dr. Dre & Alicia Keys)
Trox - Game Time (feat. K2)
D12 - 40 Oz.
John Cena - My Time Is Now
Foo Fighters - The Pretender
Instrumental Core & Really Slow Motion - Hope
Deadmau5 - Professional Griefers (feat. Gerard Way)
The Prodigy - Firestarter
Hail The Villain - Runaway
Blue Stahli - Corner
Rise Against - Architects
Disclosure - You & Me (Flume Remix) (feat. Eliza Doolittle)
Thousand Foot Krutch - Shook
Diabolic - I Don't Wanna Rhyme
Dangerkids - Paper Thin
Maino - All of the Above (Remix)
DUBB - Determination
CFO$ - Black and Blue (WWE SmackDown Reel Song)
Skillet - Feel Invincible
Eminem - 8 Mile Road (Seanh Remix)
Rob Bailey & The Hustle Standard - Haymaker
Nas - Hate Me Now (feat. Puff Daddy)
Skrillex - Bangarang (feat. Sirah)
Hollywood Undead - Dead Bite
Eminem - Rap God (DMNDZ Trap Remix)
Baauer & Kanye West & Jay Z & Just Blaze & Skrillex - GOIN' HIGH
Rob Bailey & The Hustle Standard - Hold Strong
Take Five Curfew - Kalahari
Prhyme - Mode feat. Logic
Zedd - Shave It (501 Remix)
The Glitch Mob - Our Demons (feat. Aja Volkman)
Labrinth - Earthquake (All Stars Remix) feat. Kano, Wretch 32, Tinie tempah,  Busta Ryhmes
Fatboy Slim - Push The Tempo
