Far East Movement - Like A G6 (feat. The Cataracs & DEV)
New World Sound & Thomas Newson - Flute (Tomsize & Simeon Remix)
Major Lazer & DJ Snake - Lean On (T-Mass Remix)
Razihel & Aero Chord - Titans
Veorra - Run
Effeil 65 - Blue (KNY Factory Remix)
Katy Perry - Dark Horse (PHYNX BOOTLEG)
Feenixpawl - Ghosts (HUXTER Remix)
Zedd - Beautiful Now (feat. Jon Bellion) (Marshmello Remix)
Eva Simons & Sidney Samson - Escape From Love (T-Mass Remix)
Lana Del Rey - Young & Beautiful (Kaskade Remix)
Zedd - Clarity (feat. Foxes) (Brillz Remix)
Calvin Harris - Outside (feat. Ellie Goulding) (Savagez Edit)
Daft Punk - Harder, Better, Faster, Stronger (Dillon Francis Remix)
Clean Bandit - Rockabye (feat. Sean Paul & Anne-Marie) (SHAKED Remix)
San Holo - We Rise
WiDE AWAKE - Love Me (feat. Jacob Banks)
Galantis - Runaway (Gioni Remix)
Vanic X Aquilo - Vanic X Aquilo
Dimitri Vangelis & Wyman - Payback
G Eazy & Bebe Rexha - Me, Myself & I (No Sleep Remix)
NERVO - Anywhere You Go (feat. Timmy Trumpet) (Kaivon X WOLFE Remix)
Imagine Dragons - Radioactive (Synchronice Remix)
Oliver Heldens - Melody
Rae Sremmurd - No Type (Diamond Pistols Remix)
K.Flay - FML (Vanic Remix)
DJ Snake & Lil Jon - Turn Down For What (Onderkoffer Remix)
Tomsize Simeon - Jump
LOUDPVCK - More Than I Can Take (feat. Karra & Rickyxsan )
Eminem - Lose Yourself (Offset Noize & Stravy Remix)
Lukas Graham - 7 Years (T-Mass Remix) feat. Toby Romeo
Keys N Krates - Treat Me Right
Paris Blohm - Into Dust (feat. Elle Vee)
Vanix X K. Flay - Can't Sleep
Marshmello - KeEp IT MeLLo (feat. Omar LinX)
Dash Berlin & DubVision - Yesterday Is Gone (feat. Jonny Rose) (FAKHRO Remix)
JDX x Samuel James - Mumbai
The Chainsmokers - Inside Out (feat. Charlee) (ARMNHMR Remix)
Dr. Dre - The Next Episode (San Holo Remix)
TiÃ«sto & KSHMR - Secrets (feat. VASSY) (Instant Party! Remix)
Calvin Harris - Outside (feat. Ellie Goulding) (Marshmello Remix)
Tove Lo - Stay High (feat. Hippie Sabotage) (U$IK Trap Remix)
Lost Frequencies - Are You With Me (Dash Berlin Remix)
