Jessie J - Nobody's Perfect (Netsky Full Vocal Remix)
Alesso - Sweet Escape ft. Sirena
Alan Walker - Faded (Darius & Finlay Remix)
Bastille - Pompeii (Kat Krazy Remix)
Adrian Lux - Burning (feat. Dante)
Tiësto - Red Lights
Hardwell feat Chris Jones - Dare You
Hardwell feat Chris Jones - Mad World
Galantis Hook N Sling - Love On Me
Hardwell Dyro - Never Say Goodbye (feat. Bright Lights)
Bakermat - Teach Me
Lana Del Rey - Summertime Sadness (Reich & Bleich Remix)
Vicetone vs Nico Vega - Beast
Halsey - Hurricane (Arty Remix)
DubVision - Hollow (Original Mix)
Borgeous Zaeden - Yesterday
Marlon Roudette - Everybody Feeling Something (feat. K Stewart)
Clean Bandit - Real Love (feat. Jess Glynne)
Coldplay - A Sky Full of Stars (Hardwell Remix)
Lilly Wood The Prick and Robin Schulz - Prayer In C (Robin Schulz Remix)
Tristam Karma Fields - Build the Cities (Empire of Sound) [feat. Kerli]
X Ambassadors - Renegades (Stash Konig Remix)
Armin van Buuren feat Lauren Evans - Alone
Zhu - Faded (Dzeko & Torres Remix)
Martin Garrix Tiësto - The Only Way Is Up
David Guetta - Titanium (feat. Sia)
Alex Skrindo Stahl - Moments
The Chainsmokers ft Daya - Don't Let Me Down (W&W Remix)
Robin Schulz - Sugar (feat. Francesco Yates)
Armin van Buuren feat Lauren Evans - Another You (feat. Mr. Probz)
Ellie Goulding Madeon - Stay Awake
